GLB1_LIOJA	"Liolophura japonica (Acanthopleura japonica)."
GLB2_ASCSU	"Ascaris suum (Pig roundworm) (Ascaris lumbricoides)."
GLB2_NIPBR	"Nippostrongylus brasiliensis."
GLB_APLJU	"Aplysia juliana (Walking sea hare)."
GLB_APLKU	"Aplysia kurodai (Kuroda's sea hare)."
GLB_APLLI	"Aplysia limacina (Slug sea hare)."
GLB_BIOGL	"Biomphalaria glabrata (Bloodfluke planorb)."
GLB_BUCUU	"Buccinum undatum (Common whelk)."
GLB_BURLE	"Bursatella leachii (Ragged sea hare)."
GLB_BUSCA	"Busycon canaliculatum (Channeled whelk)."
GLB_CERRH	"Cerithidea rhizophorarum (Water snail) (Horn shell)."
GLB_DICDE	"Dicrocoelium dendriticum (Small liver fluke)."
GLB_DOLAU	"Dolabella auricularia (Sea hare)."
GLB_ISOHY	"Isoparorchis hypselobagri."
GLB_NASMU	"Nassa mutabilis (Sea snail)."
GLB_PARCA	"Paramecium caudatum."
GLB_PAREP	"Paramphistomum epiclitum."
GLB_TETPY	"Tetrahymena pyriformis."
GLB_TETTH	"Tetrahymena thermophila."
MYG_AETPY	"Aethia pygmaea (Whiskered auklet)."
MYG_AILME	"Ailuropoda melanoleuca (Giant panda)."
MYG_ALLMI	"Alligator mississippiensis (American alligator)."
MYG_ANAPO	"Anas poecilorhyncha (Spot-billed duck)."
MYG_AOTTR	"Aotus trivirgatus (Night monkey) (Douroucouli)."
MYG_APTFO	"Aptenodytes forsteri (Emperor penguin)."
MYG_AUXRO	"Auxis rochei (Bullet tuna)."
MYG_BALAC	"Balaenoptera acutorostrata (Minke whale) (Lesser rorqual)."
MYG_BALPH	"Balaenoptera physalus (Finback whale) (Common rorqual)."
MYG_BOVIN	"Bos taurus (Bovine)."
MYG_BRARE	"Brachydanio rerio (Zebrafish) (Danio rerio)."
MYG_CALJA	"Callithrix jacchus (Common marmoset)."
MYG_CANFA	"Canis familiaris (Dog)."
MYG_CARCR	"Caretta caretta (Loggerhead)."
MYG_CASFI	"Castor fiber (Eurasian beaver)."
MYG_CEBAP	"Cebus apella (Brown-capped capuchin)."
MYG_CEREL	"Cervus elaphus (Red deer)."
MYG_CERMN	"Cerorhinca monocerata (Rhinoceros auklet)."
MYG_CHEMY	"Chelonia mydas (Green sea-turtle) (Chelonia agassizi)."
MYG_CHICK	"Gallus gallus (Chicken)."
MYG_CHIRA	"Chionodraco rastrospinosus (Ocellated icefish)."
MYG_CRYAN	"Cryodraco antarcticus (Crocodile icefish)."
MYG_CTEGU	"Ctenodactylus gundi (Northern gundi)."
MYG_CYPCA	"Cyprinus carpio (Common carp)."
MYG_DELDE	"Delphinus delphis (Saddleback dolphin) (Black sea dolphin)."
MYG_DELLE	"Delphinapterus leucas (Beluga whale)."
MYG_DIDMA	"Didelphis marsupialis virginiana (North American opossum)."
MYG_ELEMA	"Elephas maximus (Indian elephant)."
MYG_EQUBU	"Equus burchelli (Plains zebra) (Equus quagga)."
MYG_ERIEU	"Erinaceus europaeus (Western European hedgehog)."
MYG_ERYPA	"Erythrocebus patas (Red guenon) (Cercopithecus patas)."
MYG_ESCGI	"Eschrichtius gibbosus (California gray whale) (Eschrichtius robustus)."
MYG_GALCR	"Galago crassicaudatus (Thick-tailed galago) (Otolemur crassicaudatus)."
MYG_GALGA	"Galeorhinus galeus (Soupfin shark) (Galeorhinus australis)."
MYG_GALJA	"Galeorhinus japonicus (Shark) (Hemitriakis japonica)."
MYG_GLOME	"Globicephala melaena (Long-finned pilot whale) (Globicephala melas)."
MYG_GOBGI	"Gobionotothen gibberifrons (Humped rockcod)."
MYG_GORBE	"Gorilla gorilla beringei (Mountain gorilla) (Highland gorilla)."
MYG_GRAGE	"Graptemys geographica (Map turtle)."
MYG_HALGR	"Halichoerus grypus (Gray seal)."
MYG_HETPO	"Heterodontus portusjacksoni (Port Jackson shark)."
MYG_HORSE	"Equus caballus (Horse)."
MYG_HUMAN	"Homo sapiens (Human)."
MYG_HYLAG	"Hylobates agilis (Agile gibbon)."
MYG_HYLSY	"Hylobates syndactylus (Siamang) (Symphalangus syndactylus)."
MYG_INIGE	"Inia geoffrensis (Amazon dolphin)."
MYG_KOGSI	"Kogia simus (Dwarf sperm whale)."
MYG_LAGLA	"Lagothrix lagotricha (Common woolly monkey)."
MYG_LAGMA	"Lagostomus maximus (Plains viscacha)."
MYG_LEPMU	"Lepilemur mustelinus (Weasel lemur)."
MYG_LOXAF	"Loxodonta africana (African elephant)."
MYG_LUTLU	"Lutra lutra (European river otter)."
MYG_LYCPI	"Lycaon pictus (African wild dog) (Cape hunting dog)."
MYG_MACFA	"Macaca fascicularis (Crab eating macaque) (Cynomolgus monkey)."
MYG_MACRU	"Macropus rufus (Red kangaroo) (Megaleia rufa)."
MYG_MEGNO	"Megaptera novaeangliae (Humpback whale)."
MYG_MELME	"Meles meles (Eurasian badger)."
MYG_MESCA	"Mesoplodon carlhubbsi (Hubb's whale)."
MYG_MOUSE	"Mus musculus (Mouse)."
MYG_MUSAN	"Mustelus antarcticus (Gummy shark)."
MYG_NORMA	"Nordotis madaka (Giant abalone)."
MYG_NOTCO	"Notothenia coriiceps neglecta (Black rockcod) (Yellowbelly rockcod)."
MYG_NYCCO	"Nycticebus coucang (Slow loris)."
MYG_OCHCU	"Ochotona curzoniae (Black-lipped pika)."
MYG_OCHPR	"Ochotona princeps (Southern American pika)."
MYG_ONDZI	"Ondatra zibethicus (Muskrat)."
MYG_ORCOR	"Orcinus orca (Killer whale)."
MYG_ORNAN	"Ornithorhynchus anatinus (Duckbill platypus)."
MYG_ORYAF	"Orycteropus afer (Aardvark)."
MYG_OTOME	"Otocyon megalotis (Bat-eared fox)."
MYG_PANTR	"Pan troglodytes (Chimpanzee)."
MYG_PAPAN	"Papio anubis (Olive baboon)."
MYG_PERPO	"Perodicticus potto edwarsi (Potto)."
MYG_PHAFI	"Phalacrocorax filamentosus (Japanese cormorant)."
MYG_PHODA	"Phocoenoides dalli dalli (Dall's porpoise)."
MYG_PHOPH	"Phocoenoides phocoena (Harbor porpoise)."
MYG_PHOSI	"Phoca sibirica (Baikal seal)."
MYG_PHOVI	"Phoca vitulina (Harbor seal)."
MYG_PHYCA	"Physeter catodon (Sperm whale) (Physeter macrocephalus)."
MYG_PIG	"Sus scrofa (Pig)."
MYG_PONPY	"Pongo pygmaeus (Orangutan)."
MYG_PREEN	"Presbytis entellus (Hanuman langur)."
MYG_PROGU	"Proechimys guairae (Casiragua)."
MYG_PSEGE	"Pseudochaenichthys georgianus (South Georgia icefish)."
MYG_RABIT	"Oryctolagus cuniculus (Rabbit)."
MYG_ROUAE	"Rousettus aegyptiacus (Egyptian rousette) (Egyptian fruit bat)."
MYG_SAISC	"Saimiri sciureus (Common squirrel monkey)."
MYG_SHEEP	"Ovis aries (Sheep)."
MYG_SPAEH	"Spalax leucodon ehrenbergi (Ehrenberg's mole rat)."
MYG_SULDI	"Sulculus diversicolor (Abalone)."
MYG_TACAC	"Tachyglossus aculeatus aculeatus (Australian echidna)."
MYG_TETNG	"Tetraodon nigroviridis (Green puffer)."
MYG_THUAL	"Thunnus albacares (Yellowfin tuna) (Neothunnus macropterus)."
MYG_THUOB	"Thunnus obesus (Bigeye tuna)."
MYG_THUTH	"Thunnus thynnus (Bluefin tuna)."
MYG_THUTO	"Thunnus thynnus orientalis (North Pacific bluefin tuna)."
MYG_TUPGL	"Tupaia glis (Tree shrew)."
MYG_TURTR	"Tursiops truncatus (Atlantic bottle-nosed dolphin)."
MYG_URILO	"Uria lomvia (Bruennich guillemot) (Thick-billed murre)."
MYG_VARVA	"Varanus varius (Lace monitor)."
MYG_VULCH	"Vulpes chama (Cape fox)."
MYG_ZALCA	"Zalophus californianus (California sealion)."
MYG_ZIPCA	"Ziphius cavirostris (Goose-beaked whale)."
